28
17
22 2 0 0 0 0 0 0 0 0 0 0 0 0 0 0 0 0 0 0 0 0 0 0 0 0 1 22 
22 2 0 0 0 0 0 0 0 0 0 0 0 0 0 0 0 0 0 0 0 0 0 0 0 0 1 22 
22 2 0 0 0 0 0 0 0 0 0 0 0 0 0 0 0 0 0 0 0 0 15 16 0 0 1 22 
22 2 0 0 0 0 23 25 0 0 0 0 0 0 0 0 0 0 0 0 0 0 12 13 14 0 1 22 
22 2 15 16 0 0 0 0 0 0 0 0 0 0 0 0 0 0 23 25 0 0 0 0 0 0 26 22 
22 2 12 13 14 0 0 0 0 23 24 24 25 0 0 0 0 0 0 0 0 0 11 0 0 26 22 22 
22 2 0 0 11 0 0 0 0 0 0 0 0 0 0 23 25 0 0 0 0 3 30 30 30 22 22 22 
5 21 21 30 29 0 23 24 24 25 0 0 0 9 0 0 0 0 0 0 0 0 0 0 0 18 22 22 
22 22 19 0 0 0 0 0 0 0 0 0 1 21 21 4 0 0 23 25 0 10 0 0 0 3 22 22 
22 19 0 0 0 0 0 0 0 0 0 0 1 22 22 4 0 0 0 0 0 23 25 0 0 3 22 22 
22 2 0 0 0 0 26 21 27 9 0 26 21 22 22 27 0 0 0 0 0 0 0 0 0 26 22 22 
22 21 27 10 0 0 31 22 22 21 21 22 20 20 20 32 0 0 0 0 0 0 0 10 26 22 22 22 
22 22 22 27 0 0 18 31 20 20 20 32 19 0 0 0 0 0 0 0 26 21 21 21 22 22 22 22 
22 22 22 22 2 0 0 0 0 0 0 0 0 0 0 0 0 0 0 26 22 22 22 22 22 22 22 22 
22 22 22 22 21 27 0 0 0 0 0 0 0 0 0 0 0 0 26 22 22 22 22 22 22 22 22 22 
22 22 22 22 22 22 27 10 0 0 9 0 0 0 0 11 0 26 22 22 22 22 22 22 22 22 22 22 
22 22 22 22 22 22 22 21 21 21 21 21 21 21 21 21 21 22 22 22 22 22 22 22 22 22 22 22 
